11111111111
1P000000011
10110000101
101000010E1
11111111111
